3333333333333333333333333333333333333333333333333333
3333333333333333333333333333333333333333333333333333
3333333333333333333333333333333333333333333333333333
1113331111333333333333333333333333333333333333333333
2223332222333331111111333331111333333333333333333333
3333333333333332222222333332222111333333333333333333
3333333333333333333333333332222222111113333333333333
3333333333333333333333333332222222222221113333333333
3333333333333333333333333333333333333333333333333111
3333333333333333333333333333333333333333333331111222
3333333333333333333333333333333333333333331112222222
3333333333333333333333311333333111111333332222222222
3333333333333333333111122333333222222333333333333333
3333333333333111111222222333333222222333333333333333
3333333333111222222222222333333333333333333333333333
3333333333333333333333333333333333333333333333333333
1111133333333333333333333333333333333333333333333333
2222211111133333333333333333333333333333333333333333
2222222222211133333333333333333333333333333333333333
2222222222222211113333333333333333333333333333333333
2222222222222222223333331111133333333333333333333333
2222222222222222222333332222233333111111111333333333
3333333333333333333333322222233333222222222211333333
3333333333333333333333333333333333222222222222333333
3333333333333333333333333333333333333333333333333311
3333333333333333333333333333333333333333333333311122
3333333333333333333333333333333333333333333111122222
3333333333333333333333333333333333331111111222222222
3333333333333333333333333333333333332222222222222222
3333333311113333311113333331111133332222222222222222
1111111122224444422221111112222244442222222222222222
2222222222222222222222222222222222222222222222222222
